xxxxxxxxxxxxxxxxxxxxxxxxxxxxxxxxxxxxxxxx
x         x                   x        x
x         x                   x        x
x         x                   x        x
x         x                   x        x
x                                      x
x                                      x
x                                      x
x                                      x
x                                      x
x                                      x
x                                      x
x                                      x
x                                      x
x                                      x
x                                      x
x                                      x
x                                      x
x                                      x
x                                      x
x                                      x
x                                      x
x                                      x
x                                      x
x                                      x
x        x                    x        x
x        x                    x        x
x        x                    x        x
x        x                    x        x
xxxxxxxxxxxxxxxxxxxxxxxxxxxxxxxxxxxxxxxx