xxxxxxxxxxxxxxxxxxxxxxxxxxxxxxxxxxxxxxxx
x         x                   x        x
x         x                   x        x
x         x                   x        x
x         x                   x        x
x                                      x
x                                      x
x                                      x
x    xxxxxxxx              xxxxxxxx    x
x                                      x
x                                      x
x                                      x
xxxxxxx            x             xxxxxxx
x     x            x             x     x
x     x            x             x     x
                   x                    
x     x            x             x     x
x     x            x             x     x
xxxxxxx            x             xxxxxxx
x                                      x
x                                      x
x                                      x
x    xxxxxxxx              xxxxxxxx    x
x                                      x
x                                      x
x        x                    x        x
x        x                    x        x
x        x                    x        x
x        x                    x        x
xxxxxxxxxxxxxxxxxxxxxxxxxxxxxxxxxxxxxxxx