xxxxxxxxxxxxxxxxxxxxxxxxxxxxxxxxxxxxxxxx
x         x                   x        x
x         x                   x        x
x         x                   x        x
x         x                   x        x
x                                      x
x                                      x
x                                      x
x                                      x
x                                      x
x                                      x
x                                      x
xxxxxx             x             xxxxxxx
x                  x                   x
x                  x                   x
x                  x                   x
x                  x                   x
x                  x                   x
xxxxxx             x              xxxxxx
x                                      x
x                                      x
x                                      x
x                                      x
x                                      x
x                                      x
x        x                    x        x
x        x                    x        x
x        x                    x        x
x        x                    x        x
xxxxxxxxxxxxxxxxxxxxxxxxxxxxxxxxxxxxxxxx